****************************************************************
*                              *                               *
*                              *                               *
*                              *                               *
*                              *                               *
*                              *                               *
*                              *                               *
*                              *                               *
*                              *                               *
*                               *                              *
*                              *                               *
*                               *                              *
*                               *                              *
*                               *                              *
*                               *                              *
*                               *                              *
*                               *                              *
*                               *                              *
*                               *                              *
*                               *                              *
*                               *                              *
*                               *                              *
*                               *                              *
*		                                                       *
*		                                                       *
*		                                                       *
*		                                                       *
*		                                                       *
*		                                                       *
*		                                                       *
*		                                                       *
*		                                                       *
*		                                                       *
*		                                                       *
*		                                                       *
*		                                                       *
*		                                                       *
*		                                                       *
*		                                                       *
*		                                                       *
*		                                                       *
*		                                                       *
*		                                                       *
*		                                                       *
*		                                                       *
*		                                                       *
*		                                                       *
*		                                                       *
*		                                                       *
*		                                                       *
*		                                                       *
*		                                                       *
*		                                                       *
*		                                                       *
*		                                                       *
*		                                                       *
*		                                                       *
*		                                                       *
*		                                                       *
*		                                                       *
*		                                                       *
*		                                                       *
*		                                                       *
****************************************************************