****************
*       *      *
*       *      *
*       *      *
*       *      *
*       *      *
*       *      *
*              *
*              *
*              *
**********     *
*        *     *
*              *
*        *     *
*        *     *
****************