****************
*              *
*              *
*              *
*              *
*   ***        *
*   ***        *
*   ***        *
*   ***        *
*   ***        *
*   ****       *
*      **      *
*       **     *
*        *     *
*        *     *
****************